1111111
1ECCCN1
1CNCC11
1CCCN11
1CPCC11
1CCNC11
1111111