111111
1CCCP1
1ECCC1
1CCCC1
1CCCC1
111111